10
18
0 0 0 0 0 4 0 0 0 0 0 0 0 0 5 0 5 5
0 0 0 0 0 4 0 0 0 0 0 0 0 0 0 0 0 0
5 5 0 0 0 0 0 0 0 0 0 0 0 0 0 0 0 0
0 0 0 5 5 0 0 0 0 0 0 0 0 0 0 0 0 0
0 0 0 0 0 5 0 0 0 0 0 0 0 0 0 0 0 0 
5 5 0 0 5 5 5 5 5 5 5 0 4 4 4 4 4 4
5 5 0 5 0 0 0 5 0 0 0 0 0 0 0 0 0 0
0 0 0 0 0 0 0 0 0 0 0 0 0 0 0 0 0 0
5 5 5 5 5 5 5 5 5 5 5 5 5 5 5 5 5 5
0 0 0 0 0 0 0 0 0 0 0 0 0 0 0 0 0 0
4
0 7 1
0 8 1
0 9 1
0 10 1